1111111111111111111111111111
10010000000000000000000000C1
1000011111000000000011000001
1000011111000000000011000001
1000011111000000000011000001
1000011111000000000011000001
1P0011E000000001000000000001
1000110000000001000000000001
1000110000000001000000000001
1000000000000000000000000001
1000000000000011100000000001
1000000000000011100000000001
1000C00000000011100000000001
1111111111111111111111111111