111111111111111111111111111111111
10010000000000000000000000000E011
100001111100000000001100000000001
100001111100000000001100000000001
100001111100000000001100000000001
100001111100000000001100000000001
110011E00000000100000000000000001
100011000000000100000000000000001
100011000000000100000000000000001
100000000000000C00000000000000001
100000000000001110000000000000001
100000000000001110000000000000001
1000C00000000011110000000000000P1
111111111111111111111111111111111